00000000000000000000000000000000
02121212121211112122212122212110
02221212211112212122122122121210
02121212121211112122212122212110
02221212211112212122122122121210
02121212121211112122212122212110
02221212211112212122122122121210
02221212211112212122122122121210
02121212121211112122212122212110
02121212122122212212121221212120
01221212122212211212122121221120
01122212122121112222122121212210
02221212211112212122122122121210
02121212121211112122212122212110
02221212211112212122122122121210
02221212211112212122122122121210
02121212121211112122212122212110
00000000000000000000000000000000
