0888888888888888888888888888888
0633333333333333333333333333337
0400000000000000000000000000005
0400000000000000000000000000005
0400000000000000000000000000005
0400000000000000000000000000005
0400000000000000000000000000005
0400000000000000000000000000005
0400000000000000000000000000005
0400000000000000000000000000005
0400000000000000000000000000005
0400000000000000000000000000005
0400000000000000000000000000005
0400000000000000000000000000005
0400000000000000000000000000005
0400000000000000000000000000005
0333333333333333333333333333333
0000000000000000000000000000000
